▤▤▤▤▤▤▤▤▤▤▤▤▤▤▤▤▤▤▤▤▤▤▤▤▤▤▤▤▤▤▤▤▤▤▤▤▤▤▤▤▤▤▤▤▤▤▤▤▤▤▤▤▤▤▤▤▤▤▤▤▤▤▤▤▤▤▤▤▤▤▤▤▤▤▤▤▤▤▤▤
▤                         ▤                          ▤                         ▤
▤           ⚑             ▤                          ▤            ⚐            ▤
▤                         ▤                          ▤                         ▤
▤                         ▤                          ▤                         ▤
▤                         ▤       ○        ●         ▤                         ▤
▤                         ▤                          ▤                         ▤
▤                         ▤                          ▤                         ▤
▤   ◇                     ▤                          ▤    ◆                    ▤
▤                         ▤                          ▤                         ▤
▤              ☺          ▤                          ▤                         ▤
▤                         ▤                          ▤                         ▤
▤                         ▤                          ▤                         ▤
▤                         ▤                          ▤                         ▤
▤                         ▤                          ▤                         ▤
▤                         ▤                          ▤            ☺            ▤
▤                         ▤                          ▤                         ▤
▤                         ▤                          ▤                         ▤
▤                         ▤                          ▤                         ▤
▤                         ▤                          ▤                         ▤
▤                         ▤                          ▤                         ▤
▤                                                                              ▤
▤                                                                              ▤
▤                                                                              ▤
▤                                                                              ▤
▤                                                                              ▤
▤                                                                              ▤
▤                                                                              ▤
▤                                                                              ▤
▤▤▤▤▤▤▤▤▤▤▤▤▤▤▤▤▤▤▤▤▤▤▤▤▤▤▤▤▤▤▤▤▤▤▤▤▤▤▤▤▤▤▤▤▤▤▤▤▤▤▤▤▤▤▤▤▤▤▤▤▤▤▤▤▤▤▤▤▤▤▤▤▤▤▤▤▤▤▤▤
