▤▤▤▤▤▤▤▤▤▤▤▤▤▤▤▤▤▤▤▤▤▤▤▤▤▤▤▤▤▤▤▤▤▤▤▤▤▤▤▤▤▤▤▤▤▤▤▤▤▤▤▤▤▤▤▤▤▤▤▤▤▤▤▤▤▤▤▤▤▤▤▤▤▤▤▤▤▤▤▤
▤                         ▤                          ▤                         ▤
▤           ⚑             ▤                          ▤            ⚐            ▤
▤                         ▤                          ▤                         ▤
▤                         ▤                          ▤                         ▤
▤                         ▤○             ●           ▤                         ▤
▤                         ▤                          ▤                         ▤
▤                         ▤                          ▤                         ▤
▤   ◇                     ▤                          ▤    ◆                    ▤
▤                         ▤                          ▤                         ▤
▤                         ▤                          ▤                         ▤
▤                         ▤                          ▤                         ▤
▤            ◙            ▤                          ▤                         ▤
▤                         ▤                          ▤                         ▤
▤                         ▤                          ▤                         ▤
▤                         ▤                          ▤                         ▤
▤                         ▤                          ▤                         ▤
▤▒▒▒▒▒▒▒▒▒▒▒▒▒▒▒▒▒▒▒▒▒▒▒▒▒▤                          ▤▒▒▒▒▒▒▒▒▒▒▒▒▒▒▒▒▒▒▒▒▒▒▒▒▒▤
▤                         ▤                          ▤                         ▤
▤                         ▤                          ▤                         ▤
▤                         ▤                          ▤                         ▤
▤                         ~                          ^                         ▤
▤                         ~                          ^                         ▤
▤                         ~                          ^                         ▤
▤                         ~                          ^            ◙            ▤
▤                         ~                          ^                         ▤
▤                         ~                          ^                         ▤
▤                         ~                          ^                         ▤
▤                         ~                          ^                         ▤
▤▤▤▤▤▤▤▤▤▤▤▤▤▤▤▤▤▤▤▤▤▤▤▤▤▤▤▤▤▤▤▤▤▤▤▤▤▤▤▤▤▤▤▤▤▤▤▤▤▤▤▤▤▤▤▤▤▤▤▤▤▤▤▤▤▤▤▤▤▤▤▤▤▤▤▤▤▤▤▤
