▤▤▤▤▤▤▤▤▤▤▤▤▤▤▤▤▤▤▤▤▤▤▤▤▤▤▤▤▤▤▤▤▤▤▤▤▤▤▤▤▤▤▤▤▤▤▤▤▤▤▤▤▤▤▤▤▤▤▤▤▤▤▤▤▤▤▤▤▤▤▤▤▤▤▤▤▤▤▤▤
▤ ▤  ☺  ▤     ▤       ▤ ▤ ▤ ▤   ▤   ▤   ▤   ▤   ▤ ▤ ▤ ▤   ▤   ▤   ▤ ▤ ▤     ▤ ▤▤
▤ ▤▤▤▤▤ ▤▤▤ ▤ ▤ ▤▤▤▤▤ ▤▤▤ ▤ ▤▤▤ ▤▤▤▤▤ ▤▤▤▤▤ ▤ ▤ ▤▤▤▤▤ ▤▤▤ ▤ ▤ ▤ ▤ ▤ ▤▤▤ ▤ ▤▤▤ ▤▤
▤ ▤ ▤ ▤     ▤ ▤     ▤       ▤ ▤ ▤         ▤ ▤ ▤ ▤   ▤   ▤ ▤ ▤   ▤     ▤ ▤ ▤   ▤▤
▤ ▤▤▤ ▤ ▤ ▤▤▤ ▤▤▤ ▤▤▤▤▤▤▤▤▤ ▤ ▤▤▤▤▤ ▤▤▤ ▤▤▤▤▤ ▤▤▤ ▤▤▤▤▤ ▤▤▤ ▤ ▤ ▤▤▤ ▤ ▤ ▤▤▤▤▤ ▤▤
▤       ▤ ▤       ▤       ▤   ▤ ▤ ▤ ▤     ▤   ▤ ▤   ▤   ▤ ▤ ▤ ▤ ▤ ▤ ▤   ▤ ▤    ▤
▤ ▤▤▤ ▤ ▤ ▤ ▤▤▤▤▤▤▤▤▤ ▤▤▤▤▤▤▤ ▤▤▤▤▤ ▤ ▤▤▤ ▤ ▤ ▤ ▤ ▤ ▤▤▤▤▤▤▤ ▤ ▤ ▤ ▤▤▤ ▤▤▤▤▤ ▤ ▤▤
▤ ▤       ▤ ▤   ▤ ▤ ▤ ▤   ▤ ▤   ▤   ▤     ▤   ▤     ▤ ▤ ▤ ▤ ▤     ▤   ▤ ▤   ▤ ▤▤
▤ ▤▤▤▤▤▤▤ ▤▤▤▤▤ ▤▤▤ ▤ ▤ ▤ ▤▤▤ ▤ ▤▤▤ ▤ ▤ ▤ ▤▤▤ ▤ ▤ ▤ ▤▤▤ ▤ ▤▤▤▤▤ ▤▤▤ ▤ ▤▤▤▤▤▤▤▤▤▤
▤ ▤     ▤ ▤   ▤ ▤ ▤     ▤ ▤   ▤ ▤ ▤ ▤       ▤   ▤   ▤ ▤ ▤   ▤     ▤     ▤     ▤▤
▤ ▤ ▤ ▤▤▤▤▤▤▤▤▤▤▤ ▤ ▤▤▤ ▤▤▤ ▤ ▤ ▤ ▤ ▤ ▤ ▤▤▤ ▤ ▤▤▤▤▤▤▤ ▤ ▤ ▤ ▤▤▤▤▤▤▤▤▤▤▤ ▤▤▤▤▤▤▤▤
▤ ▤               ▤ ▤     ▤   ▤       ▤ ▤ ▤ ▤ ▤ ▤ ▤ ▤           ▤ ▤     ▤ ▤ ▤ ▤▤
▤▤▤ ▤ ▤▤▤▤▤ ▤ ▤ ▤ ▤ ▤ ▤▤▤▤▤▤▤▤▤▤▤▤▤▤▤▤▤▤▤ ▤ ▤▤▤▤▤ ▤▤▤ ▤▤▤ ▤▤▤ ▤▤▤▤▤▤▤ ▤▤▤▤▤▤▤ ▤▤
▤   ▤     ▤     ▤ ▤   ▤ ▤ ▤ ▤   ▤ ▤   ▤ ▤ ▤   ▤ ▤                   ▤       ▤ ▤▤
▤▤▤ ▤▤▤ ▤▤▤▤▤▤▤▤▤▤▤▤▤▤▤ ▤▤▤ ▤ ▤▤▤ ▤ ▤ ▤ ▤▤▤ ▤ ▤▤▤ ▤ ▤ ▤▤▤▤▤ ▤ ▤▤▤ ▤▤▤▤▤▤▤ ▤▤▤ ▤▤
▤       ▤             ▤   ▤ ▤   ▤     ▤   ▤ ▤ ▤   ▤     ▤   ▤ ▤   ▤     ▤ ▤    ▤
▤▤▤ ▤▤▤▤▤▤▤ ▤ ▤ ▤ ▤ ▤ ▤ ▤ ▤ ▤▤▤▤▤▤▤ ▤▤▤ ▤▤▤▤▤▤▤▤▤ ▤ ▤ ▤ ▤ ▤ ▤ ▤ ▤▤▤ ▤▤▤▤▤▤▤▤▤ ▤▤
▤   ▤           ▤ ▤ ▤     ▤   ▤ ▤     ▤ ▤ ▤ ▤       ▤   ▤   ▤   ▤     ▤   ▤   ▤▤
▤ ▤▤▤ ▤ ▤▤▤ ▤ ▤▤▤▤▤▤▤▤▤▤▤▤▤ ▤▤▤▤▤ ▤ ▤ ▤▤▤ ▤▤▤▤▤ ▤ ▤ ▤ ▤ ▤ ▤▤▤ ▤ ▤▤▤▤▤▤▤▤▤ ▤▤▤▤▤▤
▤ ▤   ▤ ▤   ▤             ▤ ▤       ▤         ▤ ▤   ▤           ▤   ▤ ▤   ▤ ▤ ▤▤
▤▤▤▤▤▤▤▤▤ ▤ ▤ ▤ ▤▤▤▤▤ ▤ ▤▤▤ ▤ ▤ ▤▤▤ ▤ ▤ ▤ ▤ ▤ ▤ ▤ ▤▤▤▤▤▤▤▤▤ ▤ ▤▤▤ ▤ ▤ ▤▤▤ ▤▤▤ ▤▤
▤ ▤     ▤   ▤ ▤     ▤ ▤ ▤   ▤ ▤     ▤ ▤   ▤ ▤         ▤           ▤ ▤ ▤ ▤ ▤    ▤
▤ ▤ ▤ ▤▤▤▤▤ ▤▤▤▤▤▤▤▤▤▤▤ ▤▤▤ ▤ ▤ ▤ ▤ ▤▤▤▤▤ ▤ ▤ ▤ ▤ ▤▤▤ ▤ ▤ ▤▤▤ ▤▤▤ ▤▤▤ ▤▤▤▤▤ ▤ ▤▤
▤   ▤ ▤   ▤         ▤   ▤   ▤ ▤     ▤     ▤   ▤ ▤ ▤   ▤ ▤ ▤     ▤ ▤ ▤         ▤▤
▤▤▤ ▤▤▤ ▤ ▤ ▤ ▤▤▤▤▤▤▤▤▤▤▤▤▤▤▤▤▤▤▤▤▤ ▤▤▤ ▤ ▤▤▤▤▤ ▤▤▤▤▤ ▤▤▤▤▤ ▤ ▤ ▤ ▤▤▤ ▤▤▤▤▤ ▤ ▤▤
▤ ▤ ▤   ▤           ▤ ▤   ▤ ▤     ▤ ▤   ▤ ▤ ▤ ▤ ▤     ▤ ▤         ▤ ▤     ▤   ▤▤
▤▤▤▤▤▤▤ ▤▤▤ ▤▤▤ ▤ ▤ ▤▤▤ ▤ ▤▤▤▤▤ ▤ ▤▤▤ ▤▤▤▤▤ ▤ ▤ ▤▤▤ ▤ ▤▤▤ ▤ ▤ ▤ ▤▤▤ ▤▤▤ ▤ ▤▤▤▤▤▤
▤       ▤     ▤     ▤   ▤               ▤       ▤ ▤ ▤ ▤ ▤ ▤   ▤ ▤ ▤ ▤ ▤   ▤ ▤  ▤
▤ ▤ ▤▤▤ ▤▤▤▤▤ ▤ ▤▤▤ ▤▤▤ ▤ ▤ ▤▤▤▤▤▤▤ ▤▤▤▤▤▤▤ ▤ ▤ ▤ ▤ ▤ ▤ ▤▤▤▤▤ ▤▤▤▤▤ ▤ ▤ ▤ ▤▤▤ ▤▤
▤▤▤▤▤▤▤▤▤▤▤▤▤▤▤▤▤▤▤▤▤▤▤▤▤▤▤▤▤▤▤▤▤▤▤▤▤▤▤▤▤▤▤▤▤▤▤▤▤▤▤▤▤▤▤▤▤▤▤▤▤▤▤▤▤▤▤▤▤▤▤▤▤▤▤▤▤▤▤▤
